AS132337,"ALPHA NETWORKS SOLUTION PTE. LTD.,ANSPL-AS-AP",SG,33,27,6
AS6939,"Hurricane Electric LLC,HURRICANE",US,31,37,-6
AS24482,"SG.GS,SGGS-AS-AP",SG,29,28,1
AS4637,"Telstra International Limited,ASN-TELSTRA-GLOBAL",HK,18,9,9
AS3491,"""PCCW Global,BTN-ASN",US,17,26,-9
AS2914,"""NTT America,NTT-LTD-2914",US,15,18,-3
AS7713,"Telekomunikasi Indonesia (PT),telkomnet-as-ap",ID,12,28,-16
AS58453,"China Mobile,CMI-INT-HK",CN,12,0,12
AS174,"Cogent Communications,COGENT-174",US,11,15,-4
AS38001,"NewMedia Express Pte Ltd,NEWMEDIAEXPRESS-AS-AP",SG,11,26,-15
AS1828,"Unitas Global LLC,UNITAS",US,10,17,-7
AS63927,"RISE ASIA TECHNOLOGY LIMITED,RISE-HK",HK,10,16,-6
AS18106,"Viewqwest Pte Ltd,VIEWQWEST-SG-AP",SG,10,21,-11
AS55720,"Gigabit Hosting Sdn Bhd,GIGABIT-MY",MY,10,6,4
AS4826,"Obenetwork AB,VOCUS-BACKBONE-AS",,9,23,-14
AS39120,"Convergenze S.p.A.,CONVERGENZE-AS",IT,9,21,-12
AS23673,"""COGETEL Co.,ONLINE-AS",KH,8,21,-13
AS9304,"HGC Global Communications Limited,HUTCHISON-AS-AP",HK,8,29,-21
AS19551,"Incapsula Inc,INCAPSULA",US,8,3,5
AS41095,"IPTP LTD,IPTP",GB,8,13,-5
AS54574,"DMIT Cloud Services,DMIT",US,8,28,-20
AS15412,"Reliance Globalcom Limited,FLAG-AS",GB,7,3,4
AS199524,"G-Core Labs S.A.,GCORE",LU,7,11,-4
AS7545,"TPG Internet Pty Ltd,TPG-INTERNET-AP",AU,7,17,-10
AS7660,"Asia Pacific Advanced Network - Japan,APAN-JP",JP,7,18,-11
AS140627,"ONEQODE ASSETS PTY LTD,ONEQODEASSETS-AS-AP",AU,7,16,-9
AS20473,"""The Constant Company,AS-CHOOPA",US,7,12,-5
AS2603,"NORDUnet,NORDUNET",DK,6,10,-4
AS14061,"""DigitalOcean,DIGITALOCEAN-ASN",US,6,9,-3
AS20485,"Joint Stock Company TransTeleCom,TRANSTELECOM",RU,6,14,-8
AS7575,"AARNet,AARNET-AS-AP",AU,6,9,-3
AS8359,"MTS PJSC,MTS",RU,6,21,-15
AS45474,"NEXUSGUARD LIMITED,NEXUSGUARD-AS-AP",HK,6,3,3
AS138997,"Eons Data Communications Limited,EDCL-AS-AP",HK,6,0,6
AS1299,"Telia Company AB,TWELVE99",SE,5,13,-8
AS4134,"China Telecom,CHINANET-BACKBONE",CN,5,0,5
AS9244,"Diyixian.com Limited,ASN-DYXNET-TW-AP",HK,5,0,5
AS14907,"Wikimedia Foundation Inc.,WIKIMEDIA",US,5,1,4
AS17639,"ComClark Network & Technology Corp,CONVERGE-AS",PH,5,5,0
AS36351,"SoftLayer Technologies Inc.,SOFTLAYER",US,5,8,-3
AS45352,"IP ServerOne Solutions Sdn Bhd,IPSERVERONE-AS-AP",MY,5,11,-6
AS4788,"""Tmnet,TMNET-AS-AP",MY,5,4,1
AS9002,"RETN Limited,RETN-AS",GB,5,4,1
AS13335,"""Cloudflare,CLOUDFLARENET",US,5,3,2
AS1280,"""Internet Systems Consortium,ISC-AS-1280",US,4,2,2
AS2516,"KDDI CORPORATION,KDDI",JP,4,5,-1
AS3356,"""Level 3 Parent,LEVEL3",US,4,10,-6
AS7473,"Singapore Telecommunications (SINGTEL Internet Exchange),SINGTEL-AS-AP",SG,4,13,-9
AS20940,"Akamai International B.V.,AKAMAI-ASN1",NL,4,5,-1
AS21859,"Zenlayer Inc,ZEN-ECN",US,4,18,-14
AS51185,"Onecom Global Communications LTD,ONECOM-AS",GB,4,9,-5
AS58511,"ANYCAST HOLDINGS PTY LTD,ANYCAST-GLOBAL-BACKBONE",AU,4,14,-10
AS63956,"Colocation Australia Pty Ltd,COLO-AS-AP",AU,4,12,-8
AS137409,"GSL Networks Pty LTD,GSLNETWORKS-AS-AP",AU,4,8,-4
AS29791,"Internap Holding LLC,VOXEL-DOT-NET",US,4,4,0
AS30286,"ThreatMetrix Inc.,THM",US,4,1,3
AS132825,"MYTEK TRADING PTY LTD,MYTEK-AS-AP",AU,4,4,0
AS19151,"""BroadbandONE,BBO-1",US,4,3,1
AS13030,"Init7 (Switzerland) Ltd.,INIT7",CH,4,2,2
AS45250,"Vocom International Telecommunication Inc.,VOCOM-AP-AS",US,4,3,1
AS139750,"IDCServices.net Inc,IDCSERVICESNETINC-AS-AP",VG,4,1,3
AS60068,"Datacamp Limited,CDN77",GB,4,3,1
AS1267,"WIND TRE S.P.A.,ASN-WINDTRE",IT,3,6,-3
AS2497,"Internet Initiative Japan Inc.,IIJ",JP,3,3,0
AS3216,"""PJSC """"Vimpelcom"""""",SOVAM-AS",RU,3,7,-4
AS4657,"Starhub Internet Pte Ltd,STARHUB-INTERNET",SG,3,4,-1
AS8220,"COLT Technology Services Group Limited,COLT",GB,3,9,-6
AS9268,"Over the Wire Pty Ltd,OVERTHEWIRE-AS-AP",AU,3,12,-9
AS9902,"NeocomISP Limited,NEOCOMISP-KH-AP",KH,3,9,-6
AS12552,"GlobalConnect AB,IPO-EU",SE,3,5,-2
AS13237,"euNetworks GmbH,LAMBDANET-AS",DE,3,6,-3
AS13786,"""Seabras 1 USA,SEABRAS-1",US,3,9,-6
AS16552,"Tiggee LLC,TIGGEE",US,3,10,-7
AS24429,"""Alibaba (US) Technology Co.,Taobao",US,3,2,1
AS24516,"Virtutel Pty Ltd,VIRTUTEL-AS-AP",AU,3,12,-9
AS38880,"Micron21 Datacentre Pty Ltd,M21-AS-AP",AU,3,12,-9
AS39351,"31173 Services AB,ESAB-AS",SE,3,6,-3
AS58952,"""Frontiir Co.,FRONTIIRCOLTD-MM",MM,3,9,-6
AS59605,"MENA LEVANT W.L.L,ZAINGP-AS",BH,3,12,-9
AS4058,"CITIC Telecom International CPC Limited,CITICTEL-CPC-AS4058",HK,3,1,2
AS4608,"Asia Pacific Network Information Centre,APNIC-SERVICES",AU,3,3,0
AS10099,"China Unicom (Hong Kong) Operations Limited,UNICOM-Global",HK,3,4,-1
AS137557,"""International gateway co.,IGCL-AS-AP",TH,3,7,-4
AS17213,"SUPERSAFECLOUD LLC,SSCLOUD",US,3,0,3
AS133847,"Anpple Tech Enterprise,ICT-AS-AP",MY,3,1,2
AS53587,"""AZURE TECHNOLOGY CO.,AZT",US,3,2,1
AS293,"ESnet,ESNET",US,2,4,-2
AS559,"SWITCH,SWITCH",CH,2,5,-3
AS1239,"Sprint,SPRINTLINK",US,2,4,-2
AS2152,"""California State University,CSUNET-NW",US,2,0,2
AS3223,"Voxility LLP,VOXILITY",GB,2,5,-3
AS3267,"""Federal State Institution """"Federal Scientific Research Institute for System Analysis of the Russian Academy of Sciences"""""",RUNNET",RU,2,2,0
AS3292,"TDC A/S,TDC",DK,2,2,0
AS3614,"""Dell,DELL-BLK",US,2,0,2
AS5713,"Telkom SA Ltd.,SAIX-NET",ZA,2,7,-5
AS8426,"Claranet Limited,CLARANET-AS",GB,2,6,-4
AS8447,"A1 Telekom Austria AG,A1TELEKOM-AT",AT,2,5,-3
AS10310,"Oath Holdings Inc.,YAHOO-1",US,2,1,1
AS12637,"SEEWEB s.r.l.,SEEWEB",IT,2,2,0
AS12779,"IT.Gate S.p.A.,ITGATE",IT,2,6,-4
AS14537,"Continent 8 LLC,CL-1379-14537",US,2,4,-2
AS15547,"netplus.ch SA,NETPLUS",CH,2,5,-3
AS15605,"Connesi s.p.a.,CONNESI",IT,2,5,-3
AS20764,"CJSC RASCOM,RASCOM-AS",RU,2,8,-6
AS20932,"Services Industriels de Geneve,SIG-ST",CH,2,4,-2
AS25091,"IP-Max SA,IP-MAX",CH,2,6,-4
AS28917,"""Fiord Networks,Fiord-AS",LT,2,6,-4
AS30844,"Liquid Telecommunications Ltd,LIQUID-AS",GB,2,4,-2
AS31019,"Paulus M. Hoogsteder,MEANIE",NL,2,5,-3
AS31133,"PJSC MegaFon,MF-MGSM-AS",RU,2,5,-3
AS33891,"Core-Backbone GmbH,CORE-BACKBONE",DE,2,5,-3
AS34224,"Neterra Ltd.,NETERRA-AS",BG,2,6,-4
AS34288,"Kantonsschule Zug,AS34288",CH,2,5,-3
AS35280,"ACORUS NETWORKS SAS,ACORUS",FR,2,6,-4
AS35598,"Inetcom LLC,INETCOM",RU,2,7,-5
AS37468,"Angola Cables,ANGOLA-CABLES",AO,2,4,-2
AS37497,"Network Platforms (PTY) LTD,Network-Platforms",ZA,2,6,-4
AS39122,"Blacknight Internet Solutions Limited,BLACKNIGHT-AS",IE,2,6,-4
AS39737,"Net Vision Telecom SRL,Prime-Telecom-AS",RO,2,4,-2
AS41805,"SAWAD LAND for Information Technology Ltd,IQ-SAWADLAND-AS",IQ,2,7,-5
AS47147,"ANEXIA Internetdienstleistungs GmbH,AS-ANX",AT,2,6,-4
AS47957,"Compagnie Industrielle Et Financiere D' Ingenierie Ingenico SA,ING-AS",FR,2,5,-3
AS48362,"Stadtwerke Feldkirch,TKSWF-AS",AT,2,5,-3
AS49605,"Digital Telecommunication Services S.r.l.,DTS-AS",IT,2,5,-3
AS50629,"LWLcom GmbH,LWLCOM",DE,2,7,-5
AS51184,"Fonira Telekom GmbH,FONIRA",AT,2,6,-4
AS52320,"""GlobeNet Cabos Submarinos Colombia,",CO,2,6,-4
AS56665,"Proximus Luxembourg S.A.,TANGO-TELINDUS",LU,2,5,-3
AS57695,"""Misaka Network,MISAKA",US,2,7,-5
AS58057,"Securebit AG,SECUREBIT",CH,2,7,-5
AS59890,"Kabel-TV Lampert GmbH & Co KG,Kabel-TV-Lampert",AT,2,4,-2
AS61568,"ALOO TELECOM - FSF TECNOLOGIA SA,",BR,2,7,-5
AS61955,"ColocationIX GmbH,ColocationIX-AS",DE,2,6,-4
AS199283,"STRUCTURED COMMUNICATIONS LIMITED,UKSCOMMS-AS",GB,2,0,2
AS207044,"Enet Telecommunications Networks Limited,ENET-AS",IE,2,1,1
AS207841,"Inferno Communications Ltd,INFERNO",GB,2,1,1
AS264479,"Turbozone Internet,",BR,2,6,-4
AS271253,"LINK BRASIL TELECOMUNICACOES LTDA,",BR,2,6,-4
AS328832,"Network Platforms (PTY) LTD,Network-Platforms-International",ZA,2,4,-2
AS398465,"""Rackdog,RACKDOG-LLC",US,2,4,-2
AS11528,"Photronics Inc.,PHOTRONICS",US,2,0,2
AS16625,"""Akamai Technologies,AKAMAI-AS",US,2,0,2
AS18018,"Gamebuilders Inc.,GAMEBUILDERS-AS-PH",PH,2,0,2
AS132046,"Sunbridge worldwide LTD,SUNBRIDGE-PH-AS-AP",PH,2,0,2
AS133089,"Qualcomm Inc,QUALCOMM-TW-AS-AP",US,2,0,2
AS133747,"TRIUMPH DYNASTY Limited,TRIUMPH-AS-AP",WS,2,0,2
AS4809,"China Telecom,CHINATELECOM-CORE-WAN-CN2",CN,2,0,2
AS6079,"RCN,RCN-AS",US,2,1,1
AS6453,"TATA COMMUNICATIONS (AMERICA) INC,AS6453",US,2,11,-9
AS6667,"Elisa Oyj,EUNET-FINLAND",FI,2,2,0
AS31972,"""Emagine Concept,EMGINECONCEPT-01",US,2,1,1
AS10764,"National Center for Supercomputing Applications,STARTAP",US,2,0,2
AS20965,"GEANT Vereniging,GEANT",NL,2,3,-1
AS9930,"TT DOTCOM SDN BHD,TTNET-MY",MY,2,1,1
AS11164,"Internet2,INTERNET2-I2PX",US,2,1,1
AS32787,"""Akamai Technologies,PROLEXIC-TECHNOLOGIES-DDOS-MITIGATION-NETWORK",US,2,2,0
AS38325,"WTP Resources Pte Ltd,WTP-AS-AP",SG,2,0,2
AS53828,"""NETWORK INNOVATIONS,NITEL",US,2,5,-3
AS59318,"S.I Group,SINET-KH",KH,2,4,-2
AS131477,"""Shanghai Huajuan Information Technology Co.,SHHJ-AS",CN,2,0,2
AS132819,"Aldford Network Solutions Limited,ANSL-AS-AP",VG,2,0,2
AS134684,"NetConn Services Ltd,NSL-AS-AP",SC,2,2,0
AS135140,"""Qun Ying Network Technology (Hong Kong) Co.,QYNTKCL-AS-AP",HK,2,0,2
AS267613,"ELETRONET S.A.,",BR,2,4,-2
AS11179,"""Aryaka Networks,ARYAKA-ARIN",US,2,0,2
AS47582,"ANSON NETWORK LIMITED,ansonnet-as-uk",GB,2,2,0
AS59360,"BBIX HONG KONG PTE. LIMITED,BBIXHK-HK",HK,2,1,1
AS40676,"Psychz Networks,AS40676",US,2,3,-1
AS135314,"IMCLOUD TECHNOLOGY COMPANY LIMITED,IMCLOUD-AS-AP",HK,2,0,2
AS206819,"ANSON NETWORK LIMITED,anl-uk",GB,2,0,2
AS11537,"Internet2,INTERNET2-RESEARCH-EDU",US,2,2,0
AS7540,"IXTech Limited,HKCIX-AS-AP",HK,2,1,1
AS138698,"""Colleagues Technology CO. ,TLTC-AS",HK,2,0,2
AS41378,"Kirino LLC,KirinoNET",US,2,4,-2
AS133953,"Mega Target Communication Limited,MTCL-AS-AP",HK,2,0,2
AS59243,"""Akatek Solutions,ASI-PH",PH,2,0,2
AS46997,"Black Mesa Corporation,NATOLAB",US,2,0,2
AS57724,"DDOS-GUARD LTD,DDOS-GUARD",RU,2,0,2
AS132585,"PCCW IMS Ltd (PCCW Business Internet Access),SIA-HK-AS",HK,2,6,-4
AS198949,"DC PROTECTION LTD,VS-AS",IL,2,2,0
AS513,"CERN - European Organization for Nuclear Research,CERN",CH,1,0,1
AS553,"Universitaet Stuttgart,BELWUE",DE,1,3,-2
AS701,"Verizon Business,UUNET",US,1,4,-3
AS703,"Verizon Business,UUNET",US,1,1,0
AS1103,"SURF B.V.,SURFNET-NL",NL,1,2,-1
AS1140,"Stichting Internet Domeinregistratie Nederland,SIDN",NL,1,0,1
AS1764,"Next Layer Telekommunikationsdienstleistungs- und Beratungs GmbH,NEXTLAYER-AS",AT,1,4,-3
AS1836,"green.ch AG,GREEN",CH,1,4,-3
AS2119,"Telenor Norge AS,TELENOR-NEXTEL",NO,1,3,-2
AS2153,"""California State University,CSUNET-NE",US,1,0,1
AS2381,"WiscNet,WISCNET1-AS",US,1,1,0
AS2856,"British Telecommunications PLC,BT-UK-AS",GB,1,0,1
AS3170,"Etheroute Ltd,VELOXSERV",GB,1,1,0
AS3214,"xTom GmbH,XTOM",DE,1,5,-4
AS3333,"Reseaux IP Europeens Network Coordination Centre (RIPE NCC),RIPE-NCC-AS",NL,1,0,1
AS3741,"Dimension Data,IS",ZA,1,4,-3
AS4455,"IX Reach Ltd,BSO",GB,1,4,-3
AS4766,"Korea Telecom,KIXS-AS-KR",KR,1,8,-7
AS6233,"xTom,XTOM",US,1,3,-2
AS6777,"Amsterdam Internet Exchange B.V.,AMS-IX-RS",NL,1,0,1
AS7489,"HostUS Solutions LLC,HOSTUS-GLOBAL-AS",US,1,3,-2
AS8283,"Netwerkvereniging Coloclue,COLOCLUE-AS",NL,1,0,1
AS8298,"Pim van Pelt,IPNG",CH,1,2,-1
AS8309,"SIPARTECH SAS,SIPARTECH",FR,1,0,1
AS8455,"Schuberg Philis B.V.,ATOM86-AS",NL,1,2,-1
AS8560,"IONOS SE,IONOS-AS",DE,1,2,-1
AS8732,"OJSC Comcor,COMCOR-AS",RU,1,5,-4
AS8758,"Iway AG,IWAY",CH,1,2,-1
AS8896,"XFIBER AS,XFIBER-AS",NO,1,1,0
AS10229,"Yahoo-Inc,YAHOO-TW1",US,1,0,1
AS12470,"Globe Development GmbH,AS12470",DE,1,3,-2
AS12859,"BIT BV,NL-BIT",NL,1,2,-1
AS14630,"""Invesco Group Services,INVESCO",US,1,2,-1
AS14840,"BR Digital,",BR,1,6,-5
AS15133,"Verizon Business,EDGECAST",US,1,1,0
AS15435,"DELTA Fiber Nederland B.V.,KABELFOON",NL,1,0,1
AS15576,"NTS workspace AG,NTS",CH,1,0,1
AS15830,"TELECITYGROUP INTERNATIONAL LIMITED,Equinix",GB,1,3,-2
AS16347,"ADISTA SAS,RMI-FITECH",FR,1,2,-1
AS20562,"Broadband Hosting B.V,OPEN-PEERING-AS",NL,1,2,-1
AS20766,"""Association """"Gitoyen"""""",GITOYEN-MAIN-AS",FR,1,1,0
AS20811,"Brennercom S.p.A.,BRENNERCOM-AS",IT,1,5,-4
AS21412,"""UAB """"Cgates"""""",CGATES-AS",LT,1,3,-2
AS24961,"myLoc managed IT AG,MYLOC-AS",DE,1,3,-2
AS25160,"Vorboss Limited,VORBOSS_AS",GB,1,2,-1
AS25220,"equada network GmbH,GLOBALNOC-AS",DE,1,3,-2
AS28186,"ITS TELECOMUNICACOES LTDA,",BR,1,6,-5
AS28716,"Reti Telematiche Italiane S.p.A. (Retelit S.p.A.),RETELIT-AS",IT,1,1,0
AS28792,"Public Internet Ltd,PUBLIC-INTERNET",GB,1,1,0
AS29075,"IELO-LIAZO SERVICES SAS,IELO",FR,1,3,-2
AS29140,"Hostserver GmbH,HOSTSERVER-AS",DE,1,3,-2
AS29467,"LUXNETWORK S.A.,LuxNetwork",LU,1,4,-3
AS30132,"""Internet Systems Consortium,ISC-F-AS",US,1,1,0
AS31025,"GHOSTnet GmbH,IAG-AS",DE,1,3,-2
AS31742,"Sota Solutions Ltd.,SOTACONNECT",GB,1,1,0
AS34019,"Hivane,HIVANE",FR,1,3,-2
AS34177,"CELESTE SAS,CELESTE-AS",FR,1,4,-3
AS34549,"meerfarbig GmbH & Co. KG,MEER-AS",DE,1,4,-3
AS34854,"Staclar Carrier Ltd.,STACLAR-CARRIER",DE,1,3,-2
AS34927,"iFog GmbH,iFog-GmbH",CH,1,4,-3
AS35266,"EX Networks Limited,EXN-AS",GB,1,1,0
AS35360,"Frederic Gargula,GARGUNET",CH,1,2,-1
AS35710,"weber.digital GmbH,WEBERCLOUD",DE,1,4,-3
AS37100,"SEACOM Limited,SEACOM-AS",MU,1,5,-4
AS37239,"ICTGlobe Management (Pty) Ltd,ICTGLOBE",ZA,1,6,-5
AS37640,"Cape Connect Internet,CAPE-CONNECT-AS",ZA,1,7,-6
AS37680,"Cool Ideas Service Provider (Pty) Ltd,COOL-IDEAS",ZA,1,5,-4
AS37721,"Virtual Technologies & Solutions,Virtual-Technologies-Solutions-SA",BF,1,5,-4
AS37989,"eSys Technologies Pte Ltd,DCS1-02-AS-AP",SG,1,2,-1
AS41695,"VOSTRON Limited,VOSTRON-AS",GB,1,3,-2
AS41811,"CONVERGENCE (GROUP NETWORKS) LIMITED,CONVERGENCE-GROUP",GB,1,3,-2
AS42473,"ANEXIA Internetdienstleistungs GmbH,AS-ANEXIA",AT,1,3,-2
AS44684,"Mythic Beasts Ltd,MYTHIC",GB,1,2,-1
AS45102,"""Alibaba (US) Technology Co.,ALIBABA-CN-NET",US,1,1,0
AS46489,"Twitch Interactive Inc.,TWITCH",US,1,0,1
AS47692,"Nessus GmbH,NESSUS",AT,1,6,-5
AS47787,"EDGOO NETWORKS UNIPESSOAL LDA,EDGOO",PT,1,3,-2
AS48166,"FORTEX CJSC,FORTEX-AS",RU,1,3,-2
AS48858,"LLC Milecom,Milecom-as",RU,1,1,0
AS48919,"UACITY Ltd.,UA-CITY-AS",UA,1,3,-2
AS49697,"Joey Julian Koenig,Joey-Network",DE,1,2,-1
AS50300,"CustodianDC Limited,CUSTDC",GB,1,1,0
AS50304,"Blix Solutions AS,BLIX",NO,1,1,0
AS50673,"Serverius Holding B.V.,Serverius-as",NL,1,0,1
AS50763,"MCKAYCOM LTD,MCKAYCOM",GB,1,1,0
AS50877,"Airbeam S.r.l.,AIRBEAM-AS",IT,1,3,-2
AS51088,"A2B IP B.V.,A2B",NL,1,0,1
AS51999,"WhiteHat Inc.,WHITEHAT",US,1,2,-1
AS54994,"QUANTIL NETWORKS INC,QUANTILNETWORKS",US,1,1,0
AS58299,"Openfactory GmbH,OPENFACTORY-AS",CH,1,3,-2
AS60501,"Sirius Technology SRL,SIRIUSTEC-IT",IT,1,2,-1
AS61696,"HV COM. DE PROD. E SERV.DE INFORMATICA LTDA,",BR,1,0,1
AS61708,"INFOCAT INFORMÁTICA LTDA,",BR,1,0,1
AS62167,"Tismi BV,Tismi",NL,1,1,0
AS64475,"Freifunk Frankfurt am Main e.V.,FREIFUNK-FRANKFURT",DE,1,2,-1
AS137280,"Kingsoft cloud corporation limited,KSYUNGLOBAL-AS-AP",HK,1,0,1
AS140079,"Garmin International Inc,GARMININTERNATIONAL-AS-AP",US,1,0,1
AS198385,"AlpineDC SA,AlpineDC",CH,1,3,-2
AS199938,"Netzwerge GmbH,NETZWERGE",DE,1,2,-1
AS205112,"PHILUNET GmbH,PHILUNET",DE,1,2,-1
AS206313,"Freifunk Nordwest e.V.,FFNW-AS",DE,1,2,-1
AS206356,"Freifunk Essen e.V.,Freifunk-Essen",DE,1,2,-1
AS209102,"Alfa Service s.r.l.,ALFASERVICE",IT,1,2,-1
AS210312,"Antonios A. Chariton,DNET",GR,1,2,-1
AS210937,"Xiufeng Guo,Showfom",DE,1,2,-1
AS213151,"Christian Elsen,CHRISELSEN",DE,1,2,-1
AS262301,"NETMIG TELECOM EIRELI,",BR,1,1,0
AS262571,"SM Networks,",BR,1,0,1
AS262822,"WE RADIO COMUNICAÇÕES LTDA EPP,",BR,1,0,1
AS262856,"Mil Negócios LTDA.,",BR,1,0,1
AS3786,"LG DACOM Corporation,LGDACOM",KR,1,4,-3
AS4181,"TDS TELECOM,TDS-AS",US,1,0,1
AS4230,"CLARO S.A.,",BR,1,2,-1
AS4515,"PCCW IMS Limited,ERX-STAR",HK,1,2,-1
AS18211,"Nomura India Services Pvt Ltd,NOMURAINDIA-AS-AP",IN,1,0,1
AS40564,"""VOCOM International Telecommunication,VOCOM-LAX-QUINBY-1",US,1,0,1
AS133948,"DONGFONG INC LIMITED,DIL-AS-AP",HK,1,0,1
AS134700,"Sinoycloud Limited,SINOYCLOUD-AS-AP",HK,1,0,1
AS135391,"AOFEI DATA INTERNATIONAL COMPANY LIMITED,AOFEI-HK",HK,1,1,0
AS137794,"Dahe tianchi (Beijing) network co. LTD,Dahe-network",CN,1,0,1
AS4844,"SuperInternet Access Pte Ltd,SUPERINTERNET-AS-AP",SG,1,4,-3
AS5413,"Daisy Corporate Services Trading Ltd,AS5413",GB,1,0,1
AS5511,"Orange S.A.,Opentransit",FR,1,2,-1
AS5650,"""Frontier Communications of America,FRONTIER-FRTR",US,1,0,1
AS6461,"Zayo Bandwidth,ZAYO-6461",US,1,4,-3
AS6762,"Telecom Italia Sparkle S.p.A.,SEABONE-NET",IT,1,4,-3
AS7018,"""AT&T Services,ATT-INTERNET4",US,1,3,-2
AS34553,"Nathan Sales,NATESALES",US,1,0,1
AS7497,"Beijing Primezone Technologies Inc.,CSTNET-AS-AP",CN,1,0,1
AS22335,"Metropolitan Research and Education Network,MREN",US,1,0,1
AS134176,"Rainbow network limited,RAIBOW-AS-AP",HK,1,3,-2
AS8095,"""Netvalue,NETVALUE",US,1,0,1
AS8100,"QuadraNet Enterprises LLC,ASN-QUADRANET-GLOBAL",US,1,1,0
AS8218,"Zayo France SAS,NEO-ASN",FR,1,3,-2
AS8468,"Cityfibre Limited,ENTANET",GB,1,1,0
AS8607,"Digital Space Group Limited,TIMICO",GB,1,0,1
AS8966,"Emirates Telecommunications Corporation,Etisalat-AS",AE,1,2,-1
AS9299,"Philippine Long Distance Telephone Co.,IPG-AS-AP",PH,1,2,-1
AS9318,"SK Broadband Co Ltd,SKB-AS",KR,1,4,-3
AS9381,"HKBN Enterprise Solutions HK Limited,HKBNES-AS-AP",HK,1,2,-1
AS2527,"Sony Network Communications Inc.,So-net",JP,1,0,1
AS2687,"""AT&T Global Network Services,ATGS-MMD-AS",US,1,1,0
AS19996,"CoreSite,ANY2-RS-WEST",US,1,4,-3
AS23661,"""CLARA ONLINE,CLARAONLINE",JP,1,0,1
AS24298,"Apollo Global Corporation,apolloglobal-ph",PH,1,0,1
AS31500,"Global Network Management Inc,GLOBALNET-AS",AG,1,4,-3
AS33717,"""Chunghwa Telecom Global,CHT-GLOBAL",US,1,0,1
AS38082,"""True International Gateway Co.,IIT-TIG-AS-AP",TH,1,3,-2
AS38321,"interTouch Pte. Ltd.,DOCOMOINTERTOUCH-HQ",SG,1,0,1
AS39326,"HighSpeed Office Limited,HSO-GROUP",GB,1,0,1
AS40065,"CNSERVERS LLC,CNSERVERS",US,1,4,-3
AS45580,"Omitech Int,OMITECHINT-PH",PH,1,1,0
AS45593,"Straits Technologies Ltd,STRAITSTECH-PH",PH,1,0,1
AS45758,"Triple T Broadband Public Company Limited,TTBP-AS-AP",TH,1,1,0
AS55303,"""Eagle Sky Co.,EAGLENET-AP",BZ,1,1,0
AS55464,"Miller Ford Technology Pte Ltd,MILLERFORD-SG",SG,1,0,1
AS58430,"""TCC Technology Co.,NDM-AS-AP",TH,1,0,1
AS58523,"Miller Ford Technology Pte Ltd,MILLERFORD-SG",SG,1,0,1
AS131933,"""TAMA Television Co.,TTV-NET",JP,1,0,1
AS131959,"YOU Communications Corporation,YOUTV",JP,1,0,1
AS132132,"Republic Telecom,REPUBLICTELECOM-SG",SG,1,0,1
AS132829,"Nevigate Communications (S) Pte Ltd,NCPL-AS-AP",SG,1,0,1
AS133858,"""MAYFAIR INTERNATIONAL TECHNOLOGIES,MAYFAIR-AS",PH,1,1,0
AS134346,"Gainlot International Co. Ltd,GICL-AS-AP",PH,1,0,1
AS135062,"FINE BRAVERY (HONG KONG) LIMITED,FBKL-AS-AP",HK,1,0,1
AS208770,"Greacon Limited,im-greacon",IM,1,2,-1
AS203391,"Cloud DNS Ltd,CLOUDNSNET",BG,1,0,1
AS16477,"ACNIELSEN,ACNIELSEN-AS",US,1,0,1
AS25152,"Reseaux IP Europeens Network Coordination Centre (RIPE NCC),K-ROOT-SERVER",NL,1,0,1
AS64078,"Star Framework Co.,STARFRAMEWORKCO",HK,1,0,1
AS140951,"IPTP LIMITED,IPTP",HK,1,0,1
AS10241,"""Options & Choices,OCI",US,1,1,0
AS11051,"""Evocative,CYBERVERSE",US,1,0,1
AS12389,"PJSC Rostelecom,ROSTELECOM-AS",RU,1,4,-3
AS2635,"""Automattic,AUTOMATTIC",US,1,0,1
AS9269,"Hong Kong Broadband Network Ltd,HKBN-AS-AP",HK,1,3,-2
AS13150,"CATO NETWORKS LTD,CATON",IL,1,1,0
AS38090,"pearlabyss,PEARLABYSS-AS-KR",KR,1,0,1
AS51747,"Internet Vikings International AB,INTERNETBOLAGET",SE,1,0,1
AS55256,"Netskope Inc,NETSKOPE",US,1,0,1
AS55329,"Telcotech Ltd,TELCOTECH-KH",KH,1,5,-4
AS55497,"""Blizzard Entertainment,BLIZZARD-AP",US,1,0,1
AS63199,"""CDS Global Cloud Co.,CDSC-AS1",US,1,2,-1
AS63928,"Freecomm Hong Kong Limited,FREECOMM-AS-AP",HK,1,3,-2
AS136041,"""Singapore Telecom,CONNECTPLUS-AS-AP",SG,1,0,1
AS137922,"IBOSS Inc.,IBOSS-AS-AP",US,1,0,1
AS138995,"Antbox Networks Limited,ANTBOX1-AS-AP",HK,1,1,0
AS139729,"Advance G Advertising Services,AGAS-AS-AP",PH,1,0,1
AS141158,"HIERO7 (M) SDN. BHD.,HSB-AS-AP",MY,1,0,1
AS206804,"EstNOC OY,EstNOC-GLOBAL",EE,1,0,1
AS22787,"""Arris Group,ARRIS",US,1,0,1
AS133741,"Waka Kotahi NZ Transport Agency,WKNTA-AS-AP",NZ,1,0,1
AS18250,"GEEK NETWORKS PTY LIMITED,GEEK-AS-AP",AU,1,0,1
AS20860,"IOMART CLOUD SERVICES LIMITED,IOMART-AS",GB,1,0,1
AS23930,"IPVG,IPVG-AS-AP",PH,1,0,1
AS133955,"""World Link International Network Co.,WLINCL-AS",HK,1,0,1
AS134117,"MING WAN ENTERPRISE,MINGWANENTERPRISE-AS-AP",MY,1,0,1
AS24490,"Trans-Eurasia Information Network (TEIN2) - SG,TEIN2-SG-AP",CN,1,0,1
AS38033,"Yahoo-Inc,YAHOO-JP2-AP",US,1,0,1
AS35661,"VIRTUA SYSTEMS SAS,VIRTUA-SYSTEMS",FR,1,2,-1
AS36231,"""Tempest Hosting,TEMPEST-HOSTING",US,1,0,1
AS38008,"Aperture Science Limited,APERTURE-AS-AP",HK,1,1,0
AS38047,"Advanced Information Company Limited,ADVANCED-AS-AP",HK,1,0,1
AS41108,"First Root UG (haftungsbeschraenkt),FirstRoot-AS",DE,1,0,1
AS45559,"Quza Tech Inc,QUZATECH-PH",PH,1,0,1
AS45634,"Sparkstation Pte Ltd,SPARKSTATION-SG-AP",SG,1,0,1
AS48024,"NEROCLOUD LTD,NEROCLOUD",GB,1,6,-5
AS51559,"Netinternet Bilisim Teknolojileri AS,NETINTERNET",TR,1,0,1
AS53356,"Free Range Cloud Hosting Inc.,FREE RANGE CLOUD",CA,1,0,1
AS53667,"FranTech Solutions,PONYNET",US,1,3,-2
AS59796,"StormWall s.r.o.,STORMWALL-AS",SK,1,0,1
AS60144,"3W Infra B.V.,THREE-W-INFRA-AS",NL,1,0,1
AS61292,"BLIX GROUP AS,BLXGRP",NO,1,2,-1
AS64096,"INTERNET HARBOUR INTERNATIONAL CO.LIMITED,BIH-Global",HK,1,0,1
AS64271,"rixCloud,RIXCLOUD-INC",US,1,1,0
AS63888,"DATA WING LIMITED,TISP-AS",HK,1,0,1
AS63959,"HONG KONG SYSCLOUD TECHNOLOGY LIMITED,HKSTL-HK",CN,1,0,1
AS137443,"Anchnet Asia Limited,ANCHGLOBAL-AS-AP",HK,1,7,-6
AS138915,"Kaopu Cloud HK Limited,KAOPU-HK",HK,1,0,1
AS135293,"""Ezlink Cloud Technology Co.,EZCHK-AS-AP",HK,1,0,1
AS202365,"Omer GOLGELI,Chronos",TR,1,0,1
AS133748,"Coretel Networks (International) Pte Ltd,CORETELNET-AS-AP",SG,1,1,0
AS134548,"DingFeng XinHui(HongKong) Technology Limited,DXTL-HK",HK,1,3,-2
AS138545,"rixCloud Limited,SNS",HK,1,1,0
AS138968,"rainbow network limited,RAINBOWIDC-AS-AP",JP,1,2,-1
AS134672,"Aquoz Solutions Inc,AQUOZSOLUTIONSINC-AS-AP",PH,1,0,1
AS136620,"VMHaus Limited,VMHAUSLIMITED-AS-AP",GB,1,1,0
AS136933,"GIGABIT SOLUTION LIMITED,GIGABITBANK-AS-AP",HK,1,3,-2
AS140224,"""STARCLOUD GLOBAL PTE.,SGPL-AS-AP",SG,1,2,-1
AS206264,"Amarutu Technology Ltd,AMARUTU-TECHNOLOGY",SC,1,2,-1
